0000001000
0000100010
0110101000
0100101010
0100111010
0100100000
0100101000
0100000100
0100110001
0100000111
