1101001001
1100100011
0001001000
0100011100
1001011110
0000010000
0101000101
0000010100
1100110001
0000001100