0000001000
0000100000
0110101011
0010101010
0100101000
0000100010
0100000011
0001100000
0100100110
0000001100