0000001000
0000100000
0110101011
0010101010
0100001010
0000100010
0100000011
0001000000
0100100110
0000001100