0000001010
0001000010
0100011000
0110101010
0100101010
0101100000
0101001100
1100001100
0100100000
0001110110