0000001000
0010100000
0100101000
0101100010
0000111010
1100100000
0001101101
0110000101
0000110101
1110000101