0101000100
0000010001
0100101010
0101100010
0001011010
1100100000
1001000101
1010010001
1000111011
1110010000