0111001001
0000100010
0010101000
1001100010
0100001001
0001100010
0100101100
0110000001
1111010111
1000001111