1000001001
1100100011
0001111000
0100000011
0001010000
1100010110
0001000100
0101100001
1100001011
0001100011