1001000001
0100001011
0101011000
0100011011
0001000010
1101010100
0001010001
0101000101
0100001000
1000100101